XXXXXXXXXXXXX
X____S______X
X_XXXXX_XXX_X
X_____X_____X
XXXX_XX_XXXXX
X_o_____o___X
X_X_XXXXX_X_X
X___X___X___X
XXX_X_o_X_XXX
X_______X___X
X_XXXXXXX_X_X
X_________o_X
X_XXXXX_XXX_X
X______E____X
XXXXXXXXXXXXX