XXXXXXXXXX
XE____o__X
X_XXXXXX_X
X___o____X
X_X_XX_X_X
X___X___oX
X_XXX_XX_X
X____S___X
XXXXXXXXXX
